*****s**************
*==*---==-***=***-=*
**===*=*-=====-**=**
*=***-*-***=***=*-=*
*-*=*=*===*-==*=**-*
*===*=*=***=***-*==*
***-*=*-*==-*#==*=**
*=*=*-*=***=***=*==*
*-==-====-====-=*--*
******************-*